TUNDRA
##########################
##########################
####PPPPPP################
####P####P################
#SPPP##PPPPPPPPPPPPP######
#######P#P#########P######
#######PPPPPP######P######
#########P##P######P######
#####PPPPP##P######P######
#####P######P######P######
#####PPPPPPPP######P######
#####W#############P######
#####WW####PPPPPPPPP######
####WWW####P##############
####WW#####P##############
###########P##############
###########PPPPPPPPPPPPPE#
##########################